
            F 220,100,0
         NO ./ruins/Tileable1k.xpm
SO ./ruins/Tileable2k.xpm









WE         ./ruins/Tileable3k.xpm
EA ./ruins/Tileable4k.xpm
C 5,30,00000000000000000000000000000000000000000000000000000000000000000000000000000000000000000000000000000000000000000000000000000000001





111111111111111111111111111
1000010100000110000000000001
1011000S0111001110000000111
100100000000001 100000001
1111111110110011111100001
1000000000110000011101111      111
1111011111111101110000001      101
1111011111111101110101001       1
1100000011010101110000001
10000000000000000110000001
1000000000000000110101001
1100000111010101111101111
1111111111111111111111111